1111111111111111111111111111111111
1E000000T000000C10000C000000000001
10000000T0000000000000000000000011
1010010010101010001001000000010101
1P000T000C00C0000000000000000000C1
1000000000T0000000TCT1000000010001
1111111111111111111111111111111111