1111111111111111111111
1E000000T000000C1000C1
10000000T0000000000001
1010010010101010001001
1P000T000C00C000000001
1000000000T0000000TCT1
1111111111111111111111