1111111111111111111111
1E0000000000000C1000C1
1000000000000000000001
1010010010101010001001
1P0000000C00C000000001
1000000000000000000C01
1111111111111111111111