1111111111111111111111
101000000000000C1000C1
1110000000000000000001
1010010010101010001001
1P0000000C00C000000001
1000000000000000000C00
1111111111111111111111